6,6,5,6,4,5,4,5,3,2,6,5
2,5,8,4,2,9,9,8,8,4,8,2
5,9,6,8,3,3,1,7,3,2,6,7
5,7,3,3,5,5,7,1,8,3,5,4
7,1,7,5,4,1,7,6,6,6,6,5
8,5,3,1,G,7,3,5,2,4,8,7
2,7,4,6,8,7,2,2,7,8,7,1
6,4,9,2,8,9,7,2,5,8,7,3
8,5,2,6,4,7,2,5,8,5,6,5
5,7,3,2,2,8,1,7,8,5,8,1
1,6,3,1,8,1,1,6,4,4,5,4
8,9,6,2,9,3,7,7,1,2,6,7
