7,3,5,6,7,7,3,1
1,2,2,1,4,7,7,1
4,3,2,7,4,1,7,5
5,6,2,1,5,2,7,1
3,1,7,2,6,G,7,1
7,2,3,4,7,2,4,6
3,2,4,1,1,2,4,2
7,4,6,4,4,6,4,7
